5
4
W W W W
W T T W
W T T W
W W W W
W T T W 